1	r01	1	8	1
2	r02	1	8	1
3	r03	1	8	1
4	r04	1	8	1
5	r05	1	8	1
6	r06	1	8	1
7	r07	1	8	1
8	r08	1	8	1
9	r09	1	8	1
10	r10	1	8	1
11	r11	1	8	1
12	r12	1	8	1
13	r13	1	8	1
14	r14	1	8	1
15	r15	1	8	1
16	r16	1	8	1
17	r17	1	8	1
18	r18	1	8	1
19	r19	1	8	1
20	r20	1	8	1
21	r21	1	8	1
22	r22	1	8	1
23	r23	1	8	1
24	r24	1	8	1
25	r25	1	8	1
26	r26	1	8	1
27	r27	1	8	1
28	r28	1	8	1
29	r29	1	8	1
30	r30	1	8	1